F 220,100,0
C 100,0,2


SO textures/south.xpm
NO textures/prueba.xpm
WE textures/west.xpm
EA textures/east.xpm


  111111111111111111
 100101000100000100011
10011010111110101101
10100010100101000001
101111101011101111111
1010000010101000011
10101111101111110101
10101001010100010101
101110101010111010101
100001111111111111111
100000101010001010001
100000001011111011101
100000101000100010001
101000101110101110111
100000100000100010101
100000000000000010101
10000000000000000001
10000000000000000001
1110000000000000011
10000000000000000001
10000000000000000001
1110000000000000011
10000000000000000001
10000000000000N00001
1110000000000000011
10000000000000000001
10000000000000000001
1110000000000000011
10000000000000000001
10000000000000000001
1110000000000000011
111111111111111111


111111
1000001
111111