
SO ./textures/south.xpm
NO ./textures/prueba.xpm
WE ./textures/west.xpm
EA ./textures/east.xpm

F 220,100,0
C 100,0,3

11111111111111111
10000000000000001
10000000000000001 111
1000000000N000001 101
10000000000000001 111
11111111111111111
